10 20
....................
........t...........
......#####.........
.....##...##........
....##.....##.......
...##.......##......
..##.........##.....
.....s..............
....................
....................
